resources/textures/tile01.png,resources/textures/tile02.png,
011111111111110
101001000100101
111111111111111
101001000100101
101001000100101
111111111111111
101001000100101
101001000100101
101001000100101
111111111111111
101001000100101
101001000100101
111111111111111
101001000100101
011111111111110
